Script started on 2019-10-31 10:17:07-04:00 [TERM="xterm-256color" TTY="/dev/pts/1" COLUMNS="80" LINES="24"]
ctran20@g7-11:/import/linux/home1/ctran20/i220a/work/lab11$ time ;s[K[Kls ![K~/cs220/labs 
/lab11/files
************************************************************************
				Exercise 1
************************************************************************

coverage  int-search  matmul-cache  parity

real	0m0.006s
user	0m0.003s
sys	0m0.000s
ctran20@g7-11:/import/linux/home1/ctran20/i220a/work/lab11$ time sleep 5

real	0m5.005s
user	0m0.002s
sys	0m0.000s
ctran20@g7-11:/import/linux/home1/ctran20/i220a/work/lab11$ time wc -l `find /etc -type f 2>/dev/null` 2>/dev/null | tail
     34 /etc/logrotate.conf.dpkg-old
    618 /etc/matplotlibrc2
     15 /etc/nftables.conf
     56 /etc/ntp.conf.dpkg-old
      3 /etc/sbclrc
     40 /etc/usb_modeswitch.conf
      1 /etc/video_format
     21 /etc/xattr.conf
     23 /etc/sysfs.conf
 166652 total

real	0m1.310s
user	0m0.035s
sys	0m0.234s
ctran20@g7-11:/import/linux/home1/ctran20/i220a/work/lab11$ time wc -l `find /etc -type f 2>/dev/null` 2>/dev/null | tail
     34 /etc/logrotate.conf.dpkg-old
    618 /etc/matplotlibrc2
     15 /etc/nftables.conf
     56 /etc/ntp.conf.dpkg-old
      3 /etc/sbclrc
     40 /etc/usb_modeswitch.conf
      1 /etc/video_format
     21 /etc/xattr.conf
     23 /etc/sysfs.conf
 166652 total

real	0m0.738s
user	0m0.039s
sys	0m0.174s
ctran20@g7-11:/import/linux/home1/ctran20/i220a/work/lab11$ time cd ..

real	0m0.001s
user	0m0.000s
sys	0m0.000s
ctran20@g7-11:/import/linux/home1/ctran20/i220a/work$ cd lab11/[1@t[1@i[1@m[1@e[1@ 

real	0m0.000s
user	0m0.000s
sys	0m0.000s

************************************************************************
				Exercise 2
************************************************************************

ctran20@g7-11:/import/linux/home1/ctran20/i220a/work/lab11$ cd parity/
ctran20@g7-11:/import/linux/home1/ctran20/i220a/work/lab11/parity$ ./parity -c - 
d 10
bash: ./parity: No such file or directory
ctran20@g7-11:/import/linux/home1/ctran20/i220a/work/lab11/parity$ ls
main.c	Makefile  parity-c.c  parity-s.c
ctran20@g7-11:/import/linux/home1/ctran20/i220a/work/lab11/parity$ make
cc -g -Wall -std=c11 -O1   -c -o parity-c.o parity-c.c
cc -g -Wall -std=c11 -O1   -c -o main.o main.c
cc   parity-c.o main.o   -o parity-c
cc -g -Wall -std=c11 -O1   -c -o parity-s.o parity-s.c
cc   parity-s.o main.o   -o parity-s
ctran20@g7-11:/import/linux/home1/ctran20/i220a/work/lab11/parity$ make[2Pls./parity -c -d 10
bash: ./parity: No such file or directory
ctran20@g7-11:/import/linux/home1/ctran20/i220a/work/lab11/parity$ ls
main.c	Makefile  parity-c.c  parity-s	  parity-s.o
main.o	parity-c  parity-c.o  parity-s.c
ctran20@g7-11:/import/linux/home1/ctran20/i220a/work/lab11/parity$ ls./parity -c -d 10
[A[C[C[C[C[C[C[C[C[C[C[C[C[C[C[C[C[C[C[C[C[C[C[C[C[C[C[C[C[C[C[C[C[C[C[C[C[C[C[C[C[C[C[C[C[C[C[C[C[C[C[C[C[C[C[C[C[C[C[C[C[C[C[C[C[C[C[C[C[C[C[C[C[C[C[C[C[C[C[C[C-c -d [1P10[A[C[C[C[C[C[C[C[C[C[C[C[C[C[C[C[C[C[C[C[C[C[C[C[C[C[C[C[C[C[C[C[C[C[C[C[C[C[C[C[C[C[C[C[C[C[C[C[C[C[C[C[C[C[C[C[C[C[C[C[C[C[C[C[C[C[C[C[C[C[C[C[C


67: 0
c6: 1
69: 1
73: 0
51: 0
ff: 1
4a: 0
ec: 0
29: 0
cd: 0
3
ctran20@g7-11:/import/linux/home1/ctran20/i220a/work/lab11/parity$ ./parity-c -d 10
[A[C[C[C[C[C[C[C[C[C[C[C[C[C[C[C[C[C[C[C[C[C[C[C[C[C[C[C[C[C[C[C[C[C[C[C[C[C[C[C[C[C[C[C[C[C[C[C[C[C[C[C[C[C[C[C[C[C[C[C[C[C[C[C[C[C[C[C[C[C[C[C[C[C[C[C[C[C[C[C -d 1[1P0[A[C[C[C[C[C[C[C[C[C[C[C[C[C[C[C[C[C[C[C[C[C[C[C[C[C[C[C[C[C[C[C[C[C[C[C[C[C[C[C[C[C[C[C[C[C[C[C[C[C[C[C[C[C[C[C[C[C[C[C[C[C[C[C[C[C[C[C[C[C[C[C[C[C[Cs -d 10[A[C[C[C[C[C[C[C[C[C[C[C[C[C[C[C[C[C[C[C[C[C[C[C[C[C[C[C[C[C[C[C[C[C[C[C[C[C[C[C[C[C[C[C[C[C[C[C[C[C[C[C[C[C[C[C[C[C[C[C[C[C[C[C[C[C[C[C[C[C[C[C[C[C[C


67: 0
c6: 1
69: 1
73: 0
51: 0
ff: 1
4a: 0
ec: 0
29: 0
cd: 0
3
ctran20@g7-11:/import/linux/home1/ctran20/i220a/work/lab11/parity$ time ./parity-s 10000000000[K[K[K[K[K[K[K00000
49997794

real	0m1.277s
user	0m1.272s
sys	0m0.004s
ctran20@g7-11:/import/linux/home1/ctran20/i220a/work/lab11/parity$ time ./parity-s 100000000[1P 100000000
[Cs 100000000
[C[C
49997794

real	0m1.264s
user	0m1.263s
sys	0m0.000s
ctran20@g7-11:/import/linux/home1/ctran20/i220a/work/lab11/parity$ cd ..

************************************************************************
				Exercise 3
************************************************************************

ctran20@g7-11:/import/linux/home1/ctran20/i220a/work/lab11$ cd matmul-cache/
ctran20@g7-11:/import/linux/home1/ctran20/i220a/work/lab11/matmul-cache$ make
cc -g -Wall -std=c11 -O1   -c -o main.o main.c
cc -g -Wall -std=c11 -O1   -c -o simple-matmul.o simple-matmul.c
cc main.o simple-matmul.o  -o simple-matmul
cc -g -Wall -std=c11 -O1   -c -o transpose-matmul.o transpose-matmul.c
cc main.o transpose-matmul.o  -o transpose-matmul
ctran20@g7-11:/import/linux/home1/ctran20/i220a/work/lab11/matmul-cache$ ./simpl 
e-matmul 4 1
2.22116e+17 7.02729e+17 9.76657e+17 2.08306e+17 
2.17616e+18 2.16772e+18 3.40213e+18 1.2273e+18 
4.86494e+18 4.48803e+18 7.27046e+18 2.8719e+18 
7.68709e+18 2.14813e+18 5.99903e+18 4.12269e+18 
ctran20@g7-11:/import/linux/home1/ctran20/i220a/work/lab11/matmul-cache$ ./transpose-matmul 4 1
2.22116e+17 7.02729e+17 9.76657e+17 2.08306e+17 
2.17616e+18 2.16772e+18 3.40213e+18 1.2273e+18 
4.86494e+18 4.48803e+18 7.27046e+18 2.8719e+18 
7.68709e+18 2.14813e+18 5.99903e+18 4.12269e+18 
ctran20@g7-11:/import/linux/home1/ctran20/i220a/work/lab11/matmul-cache$ time ./ 
simple-matmul 1500 1

real	0m10.426s
user	0m10.420s
sys	0m0.004s
ctran20@g7-11:/import/linux/home1/ctran20/i220a/work/lab11/matmul-cache$ time ./simple-matmul 1500 1[K[K[K[K[K[K[K[K[K[K[K[K[K[K[K[K[K[K[K
[Ktranspose-matmul 1500 1

real	0m8.256s
user	0m8.247s
sys	0m0.008s
ctran20@g7-11:/import/linux/home1/ctran20/i220a/work/lab11/matmul-cache$ cd ..

************************************************************************
				Exercise 4
************************************************************************

ctran20@g7-11:/import/linux/home1/ctran20/i220a/work/lab11$ cd int-search/
ctran20@g7-11:/import/linux/home1/ctran20/i220a/work/lab11/int-search$ make
cc -g -Wall -std=c11 -O1   -c -o linear-search.o linear-search.c
[01m[Klinear-search.c:[m[K In function ‘[01m[Ksearch_for_element[m[K’:
[01m[Klinear-search.c:6:1:[m[K [01;35m[Kwarning: [m[Kcontrol reaches end of non-void function [[01;35m[K-Wreturn-type[m[K]
 [01;35m[K}[m[K
 [01;35m[K^[m[K
cc -g -Wall -std=c11 -O1   -c -o main.o main.c
cc -g -Wall -std=c11 -O1   -c -o int_compare.o int_compare.c
cc   linear-search.o main.o int_compare.o   -o linear-search
cc -g -Wall -std=c11 -O1   -c -o binary-search.o binary-search.c
ctran20@g7-11:/import/linux/home1/ctran20/i220a/work/lab11/int-search$ time ./li 
ner[Kar-search 2000 2000

real	0m6.679s
user	0m6.678s
sys	0m0.000s
ctran20@g7-11:/import/linux/home1/ctran20/i220a/work/lab11/int-search$ time ./linear-search 2000 2000[A[C[C[C[C[C[C[C[C[C[C[C[C[C[C[C[C[C[C[C[C[C[C[C[C[C[C[C[C[C[C[C[C[C[C[C[C[C[C[C[C[C[C[C[C[C[C[C[C[C[C[K

[K[A[C[C[C[C[C[C[C[C[C[C[C[C[C[C[C[C[C[C[C[C[C[C[C[C[C[C[C[C[C[C[C[C[C[C[C[C[C[C[C[C[C[C[C[C[C[C[C[C[C[C[C[C[C[C[C[C[C[C[C[C[C[C[C[C[C[C[C[C[C[C[Ctime ./binary-search 21000[K[K[K[K000 2000

real	0m0.355s
user	0m0.350s
sys	0m0.004s
ctran20@g7-11:/import/linux/home1/ctran20/i220a/work/lab11/int-search$ cd ..

************************************************************************
				Exercise 5
************************************************************************

ctran20@g7-11:/import/linux/home1/ctran20/i220a/work/lab11$ cd coverage/
ctran20@g7-11:/import/linux/home1/ctran20/i220a/work/lab11/coverage$ make
cc -g -Wall -std=c11 -fprofile-arcs -ftest-coverage    coverage.c   -o coverage
ctran20@g7-11:/import/linux/home1/ctran20/i220a/work/lab11/coverage$ ./coverage  
123 322 4444[1P 4444[1P 44440 44440 44440 4444[C[C[C[C[C ^D
^C
ctran20@g7-11:/import/linux/home1/ctran20/i220a/work/lab11/coverage$ ./coverage 123 3000 4444 ^D[K[K[K
cd  s s ctran20@g7-11:/import/linux/home1/ctran20/i220a/work/lab11/coverage$ ls
coverage  coverage.c  coverage.gcda  coverage.gcno  Makefile
ctran20@g7-11:/import/linux/home1/ctran20/i220a/work/lab11/coverage$ ./coverage  
[A[C[C[C[C[C[C[C[C[C[C[C[C[C[C[C[C[C[C[C[C[C[C[C[C[C[C[C[C[C[C[C[C[C[C[C[C[C[C[C[C[C[C[C[C[C[C[C[C[C[C[C[C[C[C[C[C[C[C[C[C[C[C[C[C[C[C[C[C[C[C[C[C[C[C[C[C[C[C[C[K

[K[A[C[C[C[C[C[C[C[C[C[C[C[C[C[C[C[C[C[C[C[C[C[C[C[C[C[C[C[C[C[C[C[C[C[C[C[C[C[C[C[C[C[C[C[C[C[C[C[C[C[C[C[C[C[C[C[C[C[C[C[C[C[C[C[C[C[C[C[C[C[C[C[C[C[C[C[C[C[C[C. 
gcno
bash: ./coverage.gcno: Permission denied
ctran20@g7-11:/import/linux/home1/ctran20/i220a/work/lab11/coverage$ ./ g[K[Kgcov
bash: ./gcov: No such file or directory
ctran20@g7-11:/import/linux/home1/ctran20/i220a/work/lab11/coverage$ make clen
make: *** No rule to make target 'clen'.  Stop.
ctran20@g7-11:/import/linux/home1/ctran20/i220a/work/lab11/coverage$ make clenan
rm -f coverage *.o *~ *.gcda *.gcno
ctran20@g7-11:/import/linux/home1/ctran20/i220a/work/lab11/coverage$ make
cc -g -Wall -std=c11 -fprofile-arcs -ftest-coverage    coverage.c   -o coverage
ctran20@g7-11:/import/linux/home1/ctran20/i220a/work/lab11/coverage$ ./coverage  
200 2000 2999
^D
ctran20@g7-11:/import/linux/home1/ctran20/i220a/work/lab11/coverage$ ./gcov
bash: ./gcov: No such file or directory
ctran20@g7-11:/import/linux/home1/ctran20/i220a/work/lab11/coverage$ ./gcovcoverage 200 2000 2999
ctran20@g7-11:/import/linux/home1/ctran20/i220a/work/lab11/coverage$ ls
coverage  coverage.c  coverage.gcda  coverage.gcno  Makefile
ctran20@g7-11:/import/linux/home1/ctran20/i220a/work/lab11/coverage$ ls./coverage 200 2000 2999
d D
ctran20@g7-11:/import/linux/home1/ctran20/i220a/work/lab11/coverage$ ./coverage 200 2000 2999[A[C[C[C[C[C[C[C[C[C[C[C[C[C[C[C[C[C[C[C[C[C[C[C[C[C[C[C[C[C[C[C[C[C[C[C[C[C[C[C[C[C[C[C[C[C[C[C[C[C[C[C[C[C[C[C[Cls[K

[K[A[C[C[C[C[C[C[C[C[C[C[C[C[C[C[C[C[C[C[C[C[C[C[C[C[C[C[C[C[C[C[C[C[C[C[C[C[C[C[C[C[C[C[C[C[C[C[C[C[C[C[C[C[C[C[C[C[C[C[C[C[C[C[C[C[C[C[C[C[C[C[C
coverage  coverage.c  coverage.gcda  coverage.gcno  Makefile
ctran20@g7-11:/import/linux/home1/ctran20/i220a/work/lab11/coverage$ gcov cobn[K[Kverage.gcda
File 'coverage.c'
Lines executed:12.50% of 24
Creating 'coverage.c.gcov'

ctran20@g7-11:/import/linux/home1/ctran20/i220a/work/lab11/coverage$ gcov coverage.c
File 'coverage.c'
Lines executed:12.50% of 24
Creating 'coverage.c.gcov'

ctran20@g7-11:/import/linux/home1/ctran20/i220a/work/lab11/coverage$ exit

Script done on 2019-10-31 11:23:49-04:00 [COMMAND_EXIT_CODE="0"]
